0 0 0 0 0 0 0 0 0 0 0 0 0 0 0 0 0 0 0 0 0 0 0 0 0 0 0 0 0 0 0 0 0 0 0 0 0 0 0 0 0 0 0 0 0 0 0 0 0 0 
0 0 0 0 0 0 0 0 0 0 0 0 0 0 0 0 0 0 0 0 0 0 0 0 0 0 0 0 0 0 0 0 0 0 0 0 0 0 0 0 0 0 0 0 0 0 0 0 0 0 
0 0 0 0 0 0 2 0 0 0 0 0 2 2 0 0 0 0 0 0 0 0 0 0 0 0 0 0 0 0 0 0 0 0 0 0 0 0 0 0 0 0 0 0 0 0 0 0 0 0 
0 0 0 0 0 23 11 25 2 0 0 23 11 11 19 0 0 0 0 0 0 0 0 0 0 0 0 0 0 0 0 0 0 0 0 0 0 0 0 0 0 0 0 0 0 0 0 0 0 0 
0 0 0 0 23 11 10 11 11 25 23 11 10 11 25 2 2 2 2 0 0 0 0 0 0 0 0 0 0 0 0 0 0 0 2 2 2 0 0 0 0 0 0 0 0 0 0 0 0 0 
0 0 0 22 11 11 11 11 11 11 11 11 11 11 11 11 11 11 11 25 0 0 0 0 0 0 0 0 0 0 0 0 0 23 10 11 11 25 0 0 0 0 0 0 0 0 0 0 0 0 
0 0 0 23 11 11 10 11 11 7 7 10 10 10 10 11 11 12 12 11 25 2 2 2 2 2 2 2 2 2 2 2 23 10 7 10 12 10 25 2 2 2 0 0 0 0 0 0 0 0 
0 0 22 10 11 11 12 7 8 7 8 7 7 8 7 7 7 8 7 7 8 7 7 8 7 7 8 7 7 7 7 8 7 7 7 8 7 8 7 7 11 7 28 0 0 0 0 0 0 0 
0 0 22 11 11 10 11 12 8 8 8 8 8 8 8 8 8 8 8 8 8 8 8 8 8 8 8 8 8 8 8 8 8 8 8 8 8 8 8 8 8 8 7 19 0 0 0 0 0 0 
0 0 0 24 11 10 10 11 7 8 7 7 7 7 8 7 7 8 7 7 8 7 7 7 7 7 7 7 8 7 7 7 7 8 7 7 8 7 8 7 7 8 7 19 0 0 0 0 0 0 
0 0 0 0 24 11 10 10 11 10 10 10 7 10 7 10 10 11 11 7 10 12 10 10 7 11 10 7 8 7 10 7 11 10 10 10 10 11 10 10 7 8 7 19 0 0 0 0 0 0 
0 0 0 0 0 24 11 11 10 10 10 11 10 10 10 10 10 7 10 12 10 10 10 10 12 10 10 7 8 7 10 12 12 10 10 9 9 9 9 10 10 8 7 19 0 0 0 0 0 0 
0 0 0 0 0 16 1 1 1 1 1 1 1 1 1 6 10 10 10 12 12 12 12 9 10 9 10 8 8 7 10 10 8 8 8 9 8 9 9 7 10 8 7 19 0 0 0 0 0 0 
0 0 0 0 0 0 0 2 2 4 10 10 25 0 0 4 10 7 11 12 10 10 10 12 12 10 10 7 8 8 12 11 8 9 8 9 10 10 8 9 11 8 11 19 0 0 0 0 0 0 
0 0 0 0 0 0 22 10 12 10 8 8 8 19 23 11 10 8 10 10 9 12 9 9 12 9 10 7 8 7 10 10 8 10 9 11 10 12 9 9 12 12 11 19 0 0 0 0 0 0 
0 0 0 0 0 0 22 10 8 8 8 7 8 19 11 11 7 8 10 12 9 12 12 9 10 9 10 8 8 7 10 11 9 11 10 10 10 12 10 10 12 11 12 19 0 0 0 0 0 0 
0 0 0 0 0 0 16 1 1 1 6 7 8 19 11 10 7 8 10 10 10 10 10 9 10 10 10 7 8 7 10 12 9 12 11 9 10 11 9 10 12 12 12 19 0 0 0 0 0 0 
0 0 0 0 0 0 0 0 2 2 4 7 8 19 11 10 7 8 1 1 1 10 10 10 10 1 1 7 8 7 7 8 7 7 8 7 7 7 7 7 12 12 12 19 0 0 0 0 0 0 
0 0 0 0 0 0 0 22 11 7 8 7 8 19 12 7 8 8 8 8 8 8 8 8 8 8 8 8 8 8 8 8 8 8 8 8 8 8 8 8 8 17 1 18 0 0 0 0 0 0 
0 0 0 0 0 0 0 22 7 7 7 8 8 19 12 10 7 8 7 7 7 8 7 7 8 7 7 7 8 7 7 7 8 7 7 7 7 7 7 7 9 20 0 0 0 0 0 0 0 0 
0 0 0 0 0 0 0 22 7 8 7 7 26 0 12 10 7 8 26 10 10 10 10 10 10 10 10 10 11 10 10 11 10 10 10 10 10 10 10 8 9 28 0 0 0 0 0 0 0 0 
0 0 0 0 0 0 0 22 7 7 26 27 0 4 12 7 8 8 19 10 10 10 10 10 11 10 10 10 10 10 11 10 10 10 10 11 10 10 10 10 9 9 19 0 0 0 0 0 0 0 
0 0 0 0 0 0 2 23 7 26 0 0 23 10 11 10 7 8 19 1 1 1 1 1 1 1 1 1 1 1 1 1 1 1 1 1 1 15 11 6 8 9 19 0 0 0 0 0 0 0 
0 0 0 0 0 22 8 8 7 19 0 0 10 10 12 10 8 8 25 2 2 2 2 2 2 2 0 0 0 2 2 2 2 2 2 2 2 29 7 7 9 8 19 0 0 0 0 0 0 0 
0 0 0 0 0 22 8 7 5 18 0 0 6 10 11 7 8 7 8 7 8 7 7 8 7 10 19 0 22 7 9 9 9 9 9 9 9 9 9 9 9 8 19 0 0 0 0 0 0 0 
0 0 0 0 0 22 8 7 3 2 2 2 4 10 7 11 8 8 8 8 7 8 8 7 7 7 19 0 22 8 9 10 17 1 1 1 1 1 1 1 1 1 18 0 0 0 0 0 0 0 
0 0 0 0 0 22 8 8 7 8 7 7 7 8 8 7 7 8 5 1 1 1 6 7 8 7 19 0 22 7 9 11 19 0 0 0 0 0 0 0 0 0 0 0 0 0 0 0 0 0 
0 0 0 0 0 22 8 8 8 8 8 8 8 8 8 8 8 10 0 23 12 19 0 12 7 11 19 0 22 7 9 10 19 0 0 2 2 2 0 0 0 0 0 0 2 0 0 0 0 0 
0 0 0 0 0 0 24 10 8 7 10 7 8 7 26 27 27 27 23 7 7 19 22 12 8 5 2 2 23 7 9 11 25 0 22 10 11 10 19 0 0 0 0 22 11 25 2 2 2 0 
0 0 0 0 0 0 22 11 8 11 7 7 8 7 19 0 2 23 7 8 7 19 22 7 8 22 11 10 7 8 9 10 10 25 23 10 12 10 25 2 2 2 2 23 11 11 11 11 11 19 
0 0 0 0 0 0 22 10 8 10 11 8 8 8 19 22 7 7 7 7 7 19 22 7 8 22 11 7 8 8 8 8 8 8 10 12 7 10 11 11 12 10 10 12 11 17 1 15 11 19 
0 0 0 0 0 0 22 10 8 7 10 7 8 7 19 22 7 8 10 26 27 0 23 8 8 22 10 8 7 8 7 7 7 8 8 8 8 8 8 8 8 8 10 12 11 19 0 22 7 19 
0 0 0 0 0 0 22 10 8 10 26 24 8 8 19 22 7 7 10 19 0 23 10 7 8 0 24 8 7 10 7 10 12 10 10 10 12 10 7 10 10 8 7 12 7 19 0 22 11 19 
0 0 0 0 0 0 22 11 8 10 19 22 8 8 19 22 8 7 10 25 23 10 10 7 8 0 22 8 7 10 17 1 1 1 1 1 1 1 13 13 13 8 13 13 13 25 2 23 11 19 
0 0 0 0 0 0 22 11 8 10 19 22 8 7 19 22 7 7 10 10 10 7 7 8 7 0 22 8 8 17 0 0 0 0 0 0 0 0 13 14 14 14 14 14 13 11 7 11 11 19 
0 0 0 0 0 0 22 10 8 12 25 23 8 7 19 22 7 8 7 8 7 7 26 0 2 2 23 8 7 25 2 2 2 2 2 2 0 22 13 14 14 14 14 14 13 17 1 1 1 18 
0 0 0 0 0 0 22 11 8 11 10 8 8 8 19 22 7 8 7 7 8 7 0 22 8 7 8 8 8 8 7 10 11 7 10 10 19 22 13 14 14 14 14 14 13 19 0 0 0 0 
0 0 0 0 0 0 22 10 8 10 7 8 8 8 19 16 1 1 1 1 1 1 18 22 8 8 8 8 7 8 8 10 12 10 7 11 19 22 13 14 14 14 14 14 13 19 0 0 0 0 
0 0 0 0 0 0 22 11 8 11 11 8 8 8 19 0 0 2 2 2 0 0 0 22 7 8 17 1 1 1 1 1 1 1 1 1 18 22 13 14 14 14 14 14 13 19 0 0 0 0 
0 0 0 0 0 0 22 12 8 10 10 26 27 27 0 0 22 7 9 7 25 2 2 23 8 8 25 2 2 2 2 2 2 2 2 2 2 23 13 14 14 14 14 14 13 19 0 0 0 0 
0 0 0 0 0 0 22 8 12 7 10 25 2 0 0 0 22 8 9 7 7 7 8 7 7 8 8 7 8 8 7 8 8 8 7 8 8 8 13 14 14 14 14 14 13 19 0 0 0 0 
0 0 0 0 0 0 21 12 12 10 11 12 11 25 2 2 23 7 8 8 8 8 8 8 8 8 7 8 8 8 7 8 8 7 8 8 8 8 13 13 13 13 13 13 13 19 0 0 0 0 
0 0 0 0 0 0 16 15 12 10 7 12 11 11 7 11 10 10 17 1 1 1 1 1 1 1 1 1 1 1 1 1 1 1 1 1 1 1 1 1 1 1 1 1 1 18 0 0 0 0 
0 0 0 0 0 0 0 16 15 10 11 11 11 10 11 11 11 17 18 0 0 0 0 0 0 0 0 0 0 0 0 0 0 0 0 0 0 0 0 0 0 0 0 0 0 0 0 0 0 0 
0 0 0 0 0 0 0 0 16 1 1 1 1 1 1 1 1 18 0 0 0 0 0 0 0 0 0 0 0 0 0 0 0 0 0 0 0 0 0 0 0 0 0 0 0 0 0 0 0 0 
0 0 0 0 0 0 0 0 0 0 0 0 0 0 0 0 0 0 0 0 0 0 0 0 0 0 0 0 0 0 0 0 0 0 0 0 0 0 0 0 0 0 0 0 0 0 0 0 0 0 
0 0 0 0 0 0 0 0 0 0 0 0 0 0 0 0 0 0 0 0 0 0 0 0 0 0 0 0 0 0 0 0 0 0 0 0 0 0 0 0 0 0 0 0 0 0 0 0 0 0 
0 0 0 0 0 0 0 0 0 0 0 0 0 0 0 0 0 0 0 0 0 0 0 0 0 0 0 0 0 0 0 0 0 0 0 0 0 0 0 0 0 0 0 0 0 0 0 0 0 0 
0 0 0 0 0 0 0 0 0 0 0 0 0 0 0 0 0 0 0 0 0 0 0 0 0 0 0 0 0 0 0 0 0 0 0 0 0 0 0 0 0 0 0 0 0 0 0 0 0 0 
0 0 0 0 0 0 0 0 0 0 0 0 0 0 0 0 0 0 0 0 0 0 0 0 0 0 0 0 0 0 0 0 0 0 0 0 0 0 0 0 0 0 0 0 0 0 0 0 0 0 
