0 0 0 0 0 0 0 0 0 0 0 0 0 0 0 0 0 0 0 0 0 0 0 0 0 0 0 0 0 0 0 0 0 0 0 0 0 0 0 0 0 0 0 0 0 0 0 0 0 0 0 0 0 0 0 0 0 0 0 0 0 0 0 0 0 0 0 0 0 0 0 0 0 0 0 0 0 0 0 0 0 0 0 0 0 0 0 0 0 0 0 0 0 0 0 0 0 0 0 0 
0 0 0 0 0 0 0 0 0 0 0 0 0 0 0 0 0 0 0 0 0 0 0 0 0 0 0 0 0 0 0 0 0 0 0 0 0 0 0 0 0 0 0 0 0 0 0 0 0 0 0 0 0 0 0 0 0 0 0 0 0 0 0 0 0 0 2 2 0 0 0 0 2 2 0 0 0 0 0 0 0 0 0 0 0 2 2 2 0 0 0 0 0 0 0 0 0 0 0 0 
0 0 0 0 0 0 2 0 0 0 0 0 2 2 0 0 0 0 0 0 0 0 0 0 0 0 0 0 0 0 0 0 0 0 0 0 0 0 0 0 0 0 0 0 0 0 0 0 0 0 0 0 0 0 0 0 0 0 0 0 0 0 0 0 2 23 10 10 19 0 0 22 10 10 25 2 0 0 0 0 0 0 0 0 0 10 10 10 25 2 0 0 0 0 0 0 0 0 0 0 
0 0 0 0 0 23 11 25 2 0 0 23 11 11 19 0 0 0 0 0 0 0 0 0 0 0 0 0 0 0 0 0 0 0 0 0 0 0 0 0 0 0 0 0 0 0 0 0 0 0 0 0 0 0 0 0 0 0 0 0 0 0 2 23 10 10 7 10 25 2 0 23 10 10 10 10 25 0 0 0 0 0 0 2 23 10 10 10 10 10 25 0 0 0 0 0 0 0 0 0 
0 0 0 0 23 11 10 11 11 25 23 11 10 11 25 2 2 2 2 0 0 0 0 0 0 0 0 0 0 0 0 0 0 0 2 2 2 0 0 0 0 0 0 0 0 0 0 0 0 0 0 0 0 0 0 0 0 0 2 2 2 23 10 10 10 10 10 10 10 10 23 10 10 10 12 10 10 19 0 2 0 2 23 10 10 10 10 10 10 10 10 25 0 0 0 0 0 0 0 0 
0 0 0 22 11 11 11 11 11 11 11 11 11 11 11 11 11 11 11 25 0 0 0 0 0 0 0 0 0 0 0 0 0 23 10 11 11 25 0 0 0 0 0 0 0 0 0 0 0 0 0 0 0 0 0 0 0 22 10 10 10 10 10 7 11 10 11 10 10 10 10 10 10 10 10 10 10 19 23 10 22 10 10 10 8 8 8 8 8 10 10 10 25 0 0 0 0 0 0 0 
0 0 0 23 11 11 10 11 11 7 7 10 10 10 10 11 11 12 12 11 25 2 2 2 2 2 2 2 2 2 2 2 23 10 7 10 12 10 25 2 2 2 0 0 0 0 0 0 0 0 0 0 0 0 0 0 0 22 12 10 10 7 10 10 10 10 10 10 7 10 7 8 8 8 8 10 10 25 10 10 23 10 10 10 8 11 10 10 8 8 12 10 10 19 0 0 0 0 0 0 
0 0 22 10 11 11 12 10 8 7 8 7 7 8 7 7 7 8 7 7 8 7 7 8 7 7 8 7 7 7 7 8 7 7 7 8 7 8 7 7 11 7 28 0 0 0 0 0 0 0 0 0 0 0 0 0 0 22 10 10 8 8 8 7 8 8 10 12 11 10 8 8 8 8 8 7 10 10 10 10 10 10 10 10 8 10 10 11 8 10 10 10 10 25 0 0 0 0 0 0 
0 0 22 11 11 10 11 12 8 8 8 8 8 8 8 8 8 8 8 8 8 8 8 8 8 8 8 8 8 8 8 8 8 8 8 8 8 8 8 8 8 8 7 19 0 0 0 0 0 0 0 0 0 0 0 0 0 22 10 10 8 8 8 8 8 8 10 7 10 10 8 10 12 10 10 8 10 10 10 11 10 7 10 8 8 10 10 10 8 8 8 10 10 10 19 0 0 0 0 0 
0 0 0 24 11 10 10 11 7 8 7 7 7 7 8 7 7 8 7 7 8 7 7 7 7 7 7 7 8 7 7 7 7 8 7 7 8 7 8 7 7 8 7 19 0 0 0 0 0 0 0 0 0 0 0 0 0 23 10 10 8 10 10 10 10 8 10 10 10 10 8 10 10 10 10 8 10 10 7 11 10 10 8 8 10 10 11 10 10 10 8 7 10 10 19 0 0 0 0 0 
0 0 0 0 24 11 10 10 11 10 10 10 7 10 7 10 10 11 11 7 10 12 10 10 7 11 10 7 8 7 10 7 11 10 10 10 10 11 10 10 7 8 7 19 0 0 0 0 0 0 0 0 0 0 0 0 22 10 10 10 7 10 10 12 10 8 8 26 27 24 8 10 10 10 10 8 10 11 11 10 11 10 8 7 10 11 10 7 12 10 8 10 12 10 19 0 0 0 0 0 
0 0 0 0 0 24 11 11 10 17 1 1 15 10 10 10 10 7 10 12 10 10 10 10 12 10 10 7 8 7 10 12 12 10 10 9 9 9 9 10 10 8 7 19 0 0 0 0 0 0 0 0 0 0 0 0 22 10 10 10 8 12 11 10 10 7 8 19 0 22 7 10 10 11 10 8 10 11 10 10 7 10 8 10 10 7 11 11 10 10 8 10 10 10 19 0 0 0 0 0 
0 0 0 0 0 16 1 1 1 18 2 2 16 1 1 6 10 10 10 12 12 12 12 9 10 9 10 8 8 7 10 10 8 8 8 9 8 9 9 7 10 8 7 19 0 0 0 0 0 0 0 0 0 0 0 0 0 23 12 10 8 10 11 10 10 10 8 19 0 22 8 10 10 10 10 8 10 10 7 10 10 10 8 10 10 10 11 10 10 10 7 10 12 10 19 0 0 0 0 0 
0 0 0 0 0 0 0 2 2 29 10 10 28 0 0 4 10 7 11 12 10 10 10 12 12 10 10 7 8 8 12 11 8 9 8 9 10 10 8 9 11 8 11 19 0 0 0 0 0 0 0 0 0 0 0 0 22 10 10 10 8 10 11 10 10 12 8 19 0 22 8 10 10 10 10 8 10 10 11 10 10 10 7 12 11 10 7 10 10 8 8 10 10 10 25 0 0 0 0 0 
0 0 0 0 0 0 22 10 12 10 8 8 8 19 23 11 10 8 10 10 9 12 9 8 12 9 10 7 8 7 10 10 8 10 9 11 10 12 9 9 12 12 11 19 0 0 0 0 0 0 0 0 0 0 0 0 23 11 10 7 8 10 7 11 10 10 8 19 0 22 8 10 10 10 10 7 10 7 11 10 26 24 8 10 10 12 10 7 10 8 8 7 10 10 10 25 0 0 0 0 
0 0 0 0 0 0 22 10 8 8 8 7 8 19 11 11 7 8 10 12 9 12 12 9 10 9 10 8 8 7 10 11 9 11 10 10 10 12 10 10 12 11 12 19 0 0 0 0 0 0 0 0 0 0 0 23 10 11 10 10 8 12 10 10 10 10 8 19 0 23 8 10 11 10 8 8 10 10 10 10 19 22 8 10 10 7 10 12 10 8 8 10 10 10 10 10 19 0 0 0 
0 0 0 0 0 0 16 1 1 1 6 7 8 19 11 10 7 8 10 10 10 10 10 9 10 10 10 7 8 7 10 12 9 12 11 9 10 11 9 10 12 12 12 19 0 0 0 0 0 0 0 0 0 0 22 10 10 10 10 10 7 10 10 12 11 10 8 25 23 8 8 10 11 10 7 8 10 10 10 26 0 22 7 10 10 11 10 10 10 7 8 10 11 11 10 7 19 0 0 0 
0 0 0 0 0 0 0 0 2 2 4 7 8 19 11 10 7 8 1 1 1 10 10 8 10 1 1 7 8 7 7 8 7 7 8 7 7 7 7 7 12 11 12 19 0 0 0 0 0 0 0 0 0 0 23 10 10 8 8 8 8 10 10 10 7 10 8 8 8 7 8 10 10 10 8 26 27 27 27 0 0 22 8 10 10 11 11 10 10 10 8 10 10 11 10 10 19 0 0 0 
0 0 0 0 0 0 0 22 11 7 8 7 8 19 12 7 8 8 8 8 8 8 8 8 8 8 8 8 8 8 8 8 8 8 8 8 8 8 8 8 8 17 1 18 0 0 0 0 0 0 0 0 0 22 10 10 11 8 10 10 10 10 12 10 10 10 8 8 8 8 8 10 10 10 8 19 0 0 0 0 0 23 8 8 8 8 8 8 10 10 8 10 10 11 11 10 19 0 0 0 
0 0 0 0 0 0 0 22 7 7 7 8 8 19 12 10 7 8 7 7 7 8 7 7 8 7 7 7 8 7 7 7 8 7 7 7 7 7 7 7 9 20 0 0 0 0 0 0 0 0 0 0 0 22 10 10 10 8 10 10 12 7 11 10 7 10 10 10 10 10 10 7 10 10 8 25 0 0 0 0 22 10 10 12 10 10 10 8 12 12 8 7 10 10 10 10 19 0 0 0 
0 0 0 0 0 0 0 22 7 8 7 7 26 0 12 10 7 8 26 10 10 10 10 10 10 10 10 10 11 10 10 11 10 10 10 10 10 10 10 8 9 28 0 0 0 0 0 0 0 0 0 0 0 0 24 10 10 8 8 8 10 10 10 10 10 10 11 10 10 7 10 10 10 10 8 8 25 2 2 2 23 12 10 10 10 10 12 8 10 10 8 7 10 10 10 10 19 0 0 0 
0 0 0 0 0 0 0 22 7 7 26 27 0 4 12 7 8 8 19 10 10 10 10 10 11 10 10 10 10 10 11 10 10 10 10 11 10 10 10 10 9 9 19 0 0 0 0 0 0 0 0 0 0 0 0 24 10 11 10 7 10 12 10 12 10 10 10 10 10 8 8 8 8 10 10 8 7 8 8 8 8 8 8 8 8 8 8 8 10 10 8 10 10 11 7 10 19 0 0 0 
0 0 0 0 0 0 2 23 7 26 0 0 23 10 11 10 7 8 19 1 1 1 1 1 1 1 1 1 1 1 1 1 1 1 1 1 1 15 11 6 8 9 19 0 0 0 0 0 0 0 0 0 0 0 0 22 10 10 10 8 8 8 7 8 8 8 8 8 10 8 10 10 8 10 12 10 10 10 10 10 7 10 10 10 10 10 10 10 10 7 8 10 10 10 10 10 19 0 0 0 
0 0 0 0 0 22 8 8 7 19 0 0 10 10 12 10 8 8 25 2 2 2 2 2 2 2 0 0 0 2 2 2 2 2 2 2 2 29 7 7 9 8 19 0 0 0 0 0 0 0 0 0 0 0 0 0 24 10 10 10 10 10 12 10 12 10 8 8 10 8 11 11 8 10 10 10 7 10 11 10 10 10 7 12 10 10 12 10 10 10 8 10 12 10 10 5 0 0 0 0 
0 0 0 0 0 22 8 7 5 18 0 0 6 10 11 7 8 7 8 7 8 7 7 8 7 10 19 0 22 7 9 8 9 9 9 8 9 9 8 9 9 8 19 0 0 0 0 0 0 0 0 0 0 0 0 0 22 7 10 10 12 10 10 10 10 10 8 7 10 8 10 10 8 10 10 12 10 10 11 11 10 10 10 10 10 10 11 7 12 10 8 7 10 10 5 0 0 0 0 0 
0 0 0 0 0 22 8 7 3 2 2 2 4 10 7 11 8 8 8 8 7 8 8 7 7 7 19 0 22 8 9 10 17 1 1 1 1 1 1 1 1 1 18 0 0 0 0 0 0 0 0 0 0 0 0 0 22 10 11 10 8 8 8 8 10 10 8 8 7 8 10 10 8 8 8 8 7 8 8 8 8 8 8 8 10 10 11 10 7 10 8 10 10 10 10 19 0 0 0 0 
0 0 0 0 0 22 8 8 7 8 7 7 7 8 8 7 7 8 26 27 27 27 24 7 8 7 19 0 22 7 9 11 19 0 0 0 0 0 0 0 0 0 0 0 0 0 0 0 0 0 0 0 0 0 0 0 22 10 11 10 8 10 10 8 10 10 10 10 10 10 10 12 10 10 10 10 10 12 10 10 10 10 8 8 10 10 10 10 10 10 8 10 10 12 10 19 0 0 0 0 
0 0 0 0 0 22 8 8 8 8 8 8 8 8 8 8 8 10 19 2 2 0 22 12 7 11 19 0 22 7 8 7 19 0 0 2 2 2 0 0 0 0 0 0 2 0 0 0 0 0 0 0 0 0 0 0 23 10 12 7 8 10 10 8 12 10 10 10 8 8 8 8 8 8 8 10 10 7 10 10 12 10 10 8 12 10 7 10 10 7 8 10 11 10 10 19 0 0 0 0 
0 0 0 0 0 0 24 10 8 7 10 7 8 7 26 27 27 27 23 7 11 19 22 12 8 26 0 2 23 7 9 11 25 0 22 10 11 10 19 0 0 0 0 22 11 25 2 2 2 0 0 0 0 0 0 23 10 10 10 10 8 10 12 8 10 10 10 10 8 10 10 10 10 10 8 12 10 7 10 10 10 7 10 8 10 10 11 11 10 10 8 10 11 7 10 19 0 0 0 0 
0 0 0 0 0 0 22 11 8 11 7 7 8 7 19 0 2 23 7 8 7 19 22 7 8 19 22 10 7 8 9 10 10 25 23 10 12 10 25 2 2 2 2 23 11 11 11 11 11 19 0 0 0 0 22 10 10 11 12 10 8 9 10 8 10 10 12 10 8 10 11 10 10 10 8 10 10 10 12 10 10 10 10 8 10 7 10 10 7 10 7 10 10 10 5 0 0 0 0 0 
0 0 0 0 0 0 22 10 8 10 11 8 8 8 19 22 7 7 7 7 7 19 22 7 8 19 22 7 8 8 8 8 8 8 10 12 7 10 11 11 12 10 10 12 11 17 1 15 11 19 0 0 0 0 22 10 10 8 8 8 8 10 10 8 8 8 8 8 8 10 10 10 7 10 8 8 8 8 8 8 8 8 8 8 10 10 10 10 10 10 8 10 10 10 10 19 0 0 0 0 
0 0 0 0 0 0 22 10 8 7 10 7 8 7 19 22 7 8 10 26 27 0 23 8 8 19 22 8 7 8 7 7 7 8 8 8 8 8 8 8 8 8 10 12 11 19 0 22 7 19 0 0 0 0 22 10 10 8 8 10 12 10 10 10 10 10 10 7 10 10 10 10 10 12 10 10 10 10 10 10 10 10 10 26 27 24 10 12 10 8 8 10 11 10 10 19 0 0 0 0 
0 0 0 0 0 0 22 10 8 10 26 24 8 8 19 22 7 7 10 19 0 23 10 7 8 19 22 8 7 10 7 10 12 10 10 10 12 10 7 10 10 8 7 12 7 19 0 22 11 19 0 0 0 0 22 10 7 8 10 10 10 11 10 9 10 11 11 10 12 10 11 10 7 10 7 10 11 10 10 7 10 10 26 0 0 0 24 10 10 8 8 7 11 10 10 19 0 0 0 0 
0 0 0 0 0 0 22 11 8 10 19 22 8 8 19 22 8 7 12 25 23 10 10 7 8 19 22 8 7 10 17 1 1 1 1 1 1 15 13 13 13 8 13 13 13 25 2 23 11 19 0 0 0 0 22 11 10 8 10 10 9 10 10 10 9 10 10 12 10 10 7 10 10 10 10 10 10 10 10 12 10 10 19 0 0 0 22 10 10 8 8 10 11 11 10 19 0 0 0 0 
0 0 0 0 0 0 22 11 8 10 19 22 8 7 19 22 7 7 10 10 10 7 7 8 7 19 22 8 8 17 0 0 0 0 0 0 0 22 13 14 14 14 14 14 13 11 7 11 11 19 0 0 0 0 22 10 10 8 8 8 8 8 8 8 8 8 8 8 8 8 8 8 8 8 8 8 8 8 8 8 26 27 0 0 0 0 22 10 10 7 8 10 10 10 10 19 0 0 0 0 
0 0 0 0 0 0 22 10 8 12 25 23 8 7 19 22 7 8 7 8 7 7 26 27 27 2 23 8 7 25 2 2 2 2 2 2 0 22 13 14 14 14 14 14 13 17 1 1 1 18 0 0 0 0 22 10 10 10 11 10 10 12 10 10 10 10 7 10 12 10 10 11 11 10 10 10 7 8 8 33 19 0 0 0 0 0 22 11 10 8 8 10 10 5 1 0 0 0 0 0 
0 0 0 0 0 0 22 11 8 11 10 8 8 8 19 22 7 8 7 7 8 7 20 0 23 7 8 8 8 8 7 10 11 7 10 10 19 22 13 14 14 14 14 14 13 19 0 0 0 0 0 0 0 0 0 6 10 10 11 10 10 10 10 10 11 10 10 10 10 10 10 10 10 10 10 10 10 33 8 8 25 2 2 2 2 2 23 10 10 8 8 10 10 3 2 0 0 0 0 0 
0 0 0 0 0 0 22 10 8 10 7 8 8 8 19 16 1 1 1 1 1 1 18 22 8 8 8 8 7 8 8 10 12 10 7 11 19 22 13 14 14 14 14 14 13 19 0 0 0 0 0 0 0 0 0 0 1 1 1 1 1 1 1 1 1 1 1 1 1 1 1 1 1 1 6 10 10 8 8 33 10 10 10 11 10 10 10 10 7 8 7 10 10 10 10 19 0 0 0 0 
0 0 0 0 0 0 22 11 8 11 11 8 8 8 19 0 0 2 2 2 0 0 0 22 7 8 17 1 1 1 1 1 1 1 1 1 18 22 13 14 14 14 14 14 13 19 0 0 0 0 0 0 0 0 0 0 0 0 0 0 0 0 0 0 0 0 0 0 0 0 0 0 0 0 22 10 10 33 8 8 10 10 7 11 10 10 12 10 10 8 8 10 11 11 10 25 0 0 0 0 
0 0 0 0 0 0 22 12 8 10 10 26 27 27 0 0 22 7 9 7 25 2 2 23 8 8 25 2 2 2 2 2 2 2 2 2 2 23 13 14 14 14 14 14 13 19 0 0 0 0 0 0 0 0 0 0 0 0 0 0 0 0 0 0 0 0 0 0 0 0 0 0 0 0 22 10 10 8 33 33 10 11 10 10 11 11 11 11 10 8 8 10 10 11 10 10 19 0 0 0 
0 0 0 0 0 0 22 8 12 7 10 25 2 0 0 0 22 8 9 7 7 7 8 7 7 8 8 7 8 8 7 8 8 8 7 8 12 11 13 14 14 14 14 14 13 19 0 0 0 0 0 0 0 0 0 0 0 0 0 0 0 0 0 0 0 0 0 0 0 0 0 0 0 0 22 10 10 8 33 8 10 10 10 11 11 8 7 8 8 8 8 11 11 12 8 10 19 0 0 0 
0 0 0 0 0 0 21 12 12 10 11 12 11 25 2 2 23 7 8 8 8 8 8 8 8 8 7 8 8 8 7 8 8 7 8 8 8 12 13 13 13 13 13 13 13 19 0 0 0 0 0 0 0 0 0 0 0 0 0 0 0 0 0 0 0 0 0 0 0 0 0 0 0 0 22 10 10 33 8 33 10 12 10 10 7 8 8 8 8 8 8 11 11 10 10 10 19 0 0 0 
0 0 0 0 0 0 16 15 12 10 7 12 11 11 7 11 10 10 17 1 1 1 1 1 1 1 1 1 1 1 1 1 1 1 15 9 17 1 1 1 1 1 1 1 1 18 0 0 0 0 0 0 0 0 0 0 0 0 0 0 0 0 0 0 0 0 0 0 0 0 0 0 0 0 22 10 10 8 80 33 10 7 11 10 11 8 8 8 8 8 8 11 10 10 11 10 19 0 0 0 
0 0 0 0 0 0 0 16 15 10 11 11 11 10 11 11 11 17 18 0 0 0 0 0 0 0 0 0 0 0 0 0 0 0 36 33 35 0 0 0 0 0 0 0 0 0 0 0 0 0 0 0 0 0 0 0 0 0 0 0 0 0 0 0 0 0 0 0 0 0 0 0 0 0 0 24 10 33 33 8 10 10 11 10 11 8 8 8 8 7 8 7 11 11 8 10 19 0 0 0 
0 0 0 0 0 0 0 0 16 1 1 1 1 1 1 1 1 18 0 0 0 0 0 0 0 0 0 0 0 0 0 0 0 0 36 33 35 0 0 0 0 0 0 0 0 0 0 0 0 0 39 39 0 0 0 0 0 0 0 0 0 0 0 0 0 0 0 0 0 0 0 0 0 0 0 29 10 8 80 33 15 10 12 10 11 7 8 8 8 8 8 11 10 10 10 10 19 0 0 0 
0 0 0 0 0 0 0 0 0 0 0 0 0 0 0 0 0 0 0 0 0 0 0 0 0 0 0 0 0 0 0 0 0 0 36 33 35 0 0 0 0 0 0 0 0 0 0 0 0 42 32 32 44 39 0 0 0 0 0 0 0 0 0 0 0 0 39 39 0 0 0 0 0 0 42 81 81 33 33 33 35 15 10 8 11 8 8 8 8 8 8 11 10 10 5 1 0 0 0 0 
0 0 0 0 0 0 0 0 0 0 0 0 0 0 0 39 39 39 39 39 39 39 39 39 0 0 0 0 0 0 0 0 0 0 36 33 35 0 0 0 0 0 0 0 0 0 39 39 39 43 32 32 32 32 44 39 39 0 39 39 39 39 39 39 39 43 81 81 40 0 39 0 0 0 42 81 81 33 80 33 35 0 15 10 11 11 8 8 8 8 11 11 10 12 0 0 0 0 0 0 
0 0 0 0 0 0 0 0 0 0 0 0 0 0 42 31 31 34 31 31 31 34 31 31 44 39 0 0 0 0 0 0 0 0 36 33 35 0 0 0 0 0 0 0 39 43 32 32 32 32 32 32 81 32 32 32 32 40 81 81 81 81 81 81 81 81 70 81 44 42 81 44 39 0 0 46 81 33 33 8 19 0 21 10 11 11 8 8 8 8 8 8 7 10 0 0 0 0 0 0 
0 0 0 0 0 0 0 0 0 0 0 0 0 0 42 34 33 33 33 33 33 33 31 33 32 32 44 39 39 39 39 39 39 0 36 33 35 0 0 0 0 0 39 43 81 81 32 32 70 34 34 34 34 34 81 32 32 44 81 81 81 81 73 72 81 63 76 81 81 43 81 81 81 44 0 43 32 33 80 33 35 0 16 1 15 11 12 11 11 12 11 11 10 10 0 0 0 0 0 0 
0 0 0 0 0 0 0 0 0 0 0 0 0 0 43 31 80 32 32 32 32 32 33 33 31 32 32 34 32 32 32 81 32 44 43 33 44 0 0 0 0 42 32 32 32 81 32 32 79 34 67 80 34 34 81 32 32 32 67 81 81 81 81 81 63 66 66 72 81 81 73 72 81 81 44 32 32 80 33 33 35 0 0 0 0 1 1 6 10 10 10 5 1 1 0 0 0 0 0 0 
0 0 0 0 0 0 0 0 0 0 0 0 0 42 32 67 31 34 32 31 32 31 34 33 80 32 34 34 32 73 72 32 70 81 32 33 32 40 0 0 0 42 32 32 81 67 81 81 71 34 80 80 80 31 34 34 70 32 32 81 32 32 81 81 64 74 65 32 32 81 32 32 81 32 32 81 81 33 33 80 40 0 0 0 0 0 0 0 1 1 1 0 0 0 0 0 0 0 0 0 
0 0 0 0 0 0 0 0 0 0 0 0 0 0 46 32 32 32 63 62 32 80 34 33 31 32 34 34 67 32 73 77 76 32 34 33 32 40 0 0 0 43 32 32 80 31 33 33 33 33 80 31 80 31 80 31 64 62 32 81 81 73 72 81 81 81 81 81 81 32 73 72 32 32 32 81 32 80 33 33 35 0 0 0 0 0 0 0 0 0 0 0 0 0 0 0 0 0 0 0 
0 0 0 0 0 0 0 0 0 0 0 0 0 0 43 31 32 32 64 65 34 31 33 33 31 67 32 34 32 32 32 75 66 72 32 33 32 40 0 0 43 81 32 81 31 80 33 33 33 80 31 73 72 80 80 33 31 64 72 32 32 32 32 81 32 32 32 32 81 32 32 32 32 67 32 32 32 33 33 80 40 0 0 0 0 0 0 0 0 0 0 0 0 0 0 0 0 0 0 0 
0 0 0 0 0 0 0 0 0 0 0 0 0 42 32 67 34 34 34 32 34 80 33 31 80 34 32 34 63 62 34 75 76 32 31 33 32 44 0 42 32 81 32 81 81 32 32 32 32 67 80 80 31 80 33 31 33 31 33 31 33 80 33 31 33 80 33 31 33 80 33 31 33 33 33 33 33 80 33 33 35 0 0 0 0 0 0 0 0 0 0 0 0 0 0 0 0 0 0 0 
0 0 0 0 0 0 0 0 0 0 0 0 0 0 46 31 34 34 34 73 72 31 33 33 31 32 34 32 64 66 77 74 65 32 31 33 31 32 40 42 32 81 32 81 32 32 32 70 32 32 32 32 32 73 72 32 32 33 31 33 31 33 80 33 31 33 80 33 31 33 31 33 31 80 31 31 31 80 31 33 35 0 0 0 0 0 0 0 0 0 0 0 0 0 0 0 0 0 0 0 
0 0 0 0 0 0 0 0 0 0 0 0 0 0 42 31 32 34 34 67 34 34 33 33 31 34 34 70 34 75 76 32 32 63 62 33 31 45 0 0 46 32 81 32 32 32 63 66 77 77 77 77 77 32 32 32 32 81 81 81 32 32 32 32 32 32 32 81 81 81 81 81 32 32 32 73 78 77 72 33 35 0 0 0 0 0 0 0 0 0 0 0 0 0 0 0 0 0 0 0 
0 0 0 0 0 0 0 0 0 0 0 0 0 0 0 77 62 32 32 32 63 62 31 33 34 34 63 66 77 74 65 32 63 66 65 33 31 40 0 0 43 32 81 63 77 77 66 66 66 66 66 66 66 77 77 77 77 77 77 77 62 32 32 32 63 62 32 32 32 32 32 32 32 32 70 32 32 79 31 33 35 0 0 0 0 0 0 0 0 0 0 0 0 0 0 0 0 0 0 0 
0 0 0 0 0 0 0 0 0 0 0 0 0 0 74 74 74 62 34 73 74 65 31 33 31 34 64 74 65 32 32 32 64 65 31 33 80 44 0 42 32 32 73 66 66 66 66 66 66 66 66 66 66 66 66 66 66 66 66 66 66 77 77 77 66 66 77 77 77 62 32 32 70 32 71 32 32 79 31 33 35 0 0 0 0 0 0 0 0 0 0 0 0 0 0 0 0 0 0 0 
0 0 0 0 0 0 0 0 0 39 0 39 0 42 31 31 31 71 80 80 31 31 80 31 80 31 80 31 80 80 31 80 31 31 80 33 80 32 44 43 32 70 32 32 66 66 66 66 66 66 66 66 66 66 66 66 66 66 66 66 66 66 66 66 66 66 66 66 66 66 77 77 66 62 32 32 63 76 31 33 35 0 0 0 0 0 0 0 0 0 0 0 0 0 0 0 0 0 0 0 
0 0 0 0 0 0 0 0 43 81 71 81 44 47 33 33 33 33 33 33 33 33 33 33 33 33 33 33 33 33 33 33 33 33 33 33 31 32 32 32 32 75 77 77 66 66 66 66 66 66 74 74 66 66 66 66 66 66 66 66 66 66 66 66 66 66 66 66 66 66 66 74 74 74 62 81 75 65 31 33 35 0 0 0 0 0 0 0 0 0 0 0 0 0 0 0 0 0 0 0 
0 0 0 0 0 0 0 42 81 81 81 81 81 34 33 31 80 80 80 31 31 80 31 32 32 32 32 32 32 32 31 80 31 31 80 31 80 32 81 32 73 66 74 74 74 74 74 74 74 65 81 81 75 66 66 66 66 66 66 66 66 66 66 66 66 66 66 66 66 66 65 81 81 81 71 81 71 34 31 33 35 0 0 0 0 0 0 0 0 0 0 0 0 0 0 0 0 0 0 0 
0 0 0 0 0 0 0 42 81 81 81 67 81 67 33 31 32 32 32 32 34 32 32 32 34 32 34 34 32 32 32 32 32 32 63 62 32 32 32 70 32 79 31 80 80 80 80 80 80 31 31 31 75 74 74 66 66 66 66 66 66 66 66 66 66 66 66 66 74 65 81 81 32 81 81 67 34 81 31 33 35 0 39 0 0 0 0 0 0 0 0 0 0 0 0 0 0 0 0 0 
0 0 0 0 0 0 0 42 81 67 81 34 81 81 33 31 32 63 62 34 34 73 77 77 77 77 62 34 34 81 34 34 34 63 66 66 62 32 73 74 77 76 31 33 33 33 33 33 33 33 31 31 71 81 81 75 66 66 66 66 66 66 66 66 66 66 66 65 81 32 81 32 81 81 70 34 81 34 33 33 35 42 32 44 39 0 0 0 0 0 0 0 0 0 0 0 0 0 0 0 
0 0 0 0 0 0 0 0 46 81 81 34 81 67 33 80 32 75 74 78 72 34 75 66 74 74 74 78 78 78 78 77 77 66 66 66 66 72 32 32 64 76 80 33 31 31 31 31 31 33 33 31 31 63 78 66 66 66 66 66 66 66 66 66 66 66 76 81 81 81 81 81 81 81 71 34 34 34 33 33 44 43 67 32 32 44 39 0 0 0 0 0 0 0 0 0 0 0 0 0 
0 0 0 0 0 0 0 0 42 81 67 81 81 81 33 31 81 79 34 34 34 34 64 65 34 34 34 34 34 34 34 64 74 66 66 66 76 32 32 67 32 71 31 33 80 63 78 72 31 31 33 31 31 79 81 75 66 66 66 66 66 66 66 66 66 66 76 81 33 33 33 33 33 31 34 81 34 34 33 33 32 32 32 67 32 32 32 40 0 0 0 0 0 0 0 0 0 0 0 0 
0 0 0 0 0 0 0 0 0 46 81 67 81 34 33 31 32 71 32 33 33 33 34 33 33 33 32 33 33 33 81 32 32 64 74 74 65 32 32 81 32 32 31 33 31 79 81 81 70 31 33 33 31 79 81 75 66 66 66 66 66 66 66 66 66 66 76 33 33 33 33 33 33 33 33 31 80 31 33 33 32 32 32 32 45 46 32 40 0 0 0 0 0 0 0 0 0 0 0 0 
0 0 0 0 0 0 0 0 0 43 81 81 81 81 33 80 32 32 81 33 34 33 32 33 34 33 32 33 34 33 32 32 81 32 32 32 32 81 67 32 73 62 80 33 31 79 81 81 71 31 31 33 31 64 78 74 66 66 66 66 66 66 66 66 66 66 76 33 33 33 81 81 81 33 33 33 33 33 33 33 32 32 32 45 0 0 41 0 0 0 0 0 0 0 0 0 0 0 0 0 
0 0 0 0 0 0 0 0 42 81 81 73 72 32 33 80 80 31 31 33 32 33 32 33 81 33 80 33 32 33 31 31 80 31 80 32 34 81 32 32 32 71 31 33 31 64 77 62 81 70 31 33 31 31 81 81 64 66 66 66 66 66 66 66 66 66 76 33 81 81 34 81 81 81 81 81 81 81 33 33 33 32 32 40 0 0 0 0 0 0 0 0 0 0 0 0 0 0 0 0 
0 0 0 0 0 0 0 0 0 46 81 81 81 32 33 33 33 33 33 33 34 33 33 33 34 33 33 33 34 33 33 33 33 33 33 31 34 81 70 32 32 32 31 33 31 81 75 76 34 79 31 33 31 31 81 81 81 64 74 66 66 66 66 66 66 66 76 33 81 81 81 81 34 81 34 81 81 81 81 33 33 32 45 0 0 0 0 0 0 0 0 0 0 0 0 0 0 0 0 0 
0 0 0 0 0 0 0 0 0 0 46 81 81 67 80 31 80 31 31 80 32 31 31 31 32 81 81 80 32 80 31 80 31 31 33 31 32 73 76 32 32 67 31 33 31 81 64 76 81 79 31 31 31 31 81 34 81 81 81 64 74 74 66 66 74 66 76 33 81 73 72 81 32 32 73 72 32 32 81 33 33 32 44 0 0 0 0 0 0 0 0 0 0 0 0 0 0 0 0 0 
0 0 0 0 0 0 0 0 0 0 0 72 81 81 81 81 73 41 41 41 41 41 41 72 34 34 34 34 73 78 77 77 62 80 33 31 32 81 64 72 32 32 31 33 80 70 81 79 81 64 62 31 33 31 81 73 72 81 67 81 81 81 64 65 81 64 76 33 81 32 32 32 32 67 32 32 70 32 81 33 33 32 32 44 39 0 0 0 0 0 0 0 0 0 0 0 0 0 0 0 
0 0 0 0 0 0 0 0 0 0 42 81 81 81 70 81 81 40 0 0 0 0 43 34 34 34 31 34 34 34 75 66 65 31 33 31 34 34 32 32 32 67 80 33 31 79 81 79 34 81 79 31 33 81 81 81 81 81 34 81 67 81 81 34 81 81 79 33 81 73 77 78 62 32 32 63 65 32 67 33 33 31 32 32 32 44 39 39 39 39 39 39 0 0 0 0 0 0 0 0 
0 0 0 0 0 0 0 0 0 0 0 41 41 41 0 41 41 0 0 0 39 43 34 34 80 31 33 31 33 34 75 76 31 31 33 31 32 32 67 32 67 32 31 33 31 79 81 75 78 77 76 31 33 81 63 78 78 78 72 81 81 81 81 34 81 73 65 33 81 81 71 32 71 32 63 65 32 32 32 70 33 80 31 67 32 32 32 32 32 32 32 32 40 0 0 0 0 0 0 0 
0 0 0 0 0 0 0 0 0 0 0 0 39 39 39 39 39 0 0 42 34 34 31 33 80 80 34 70 80 33 75 76 80 33 33 31 32 81 32 81 32 81 80 33 31 75 78 76 81 64 76 31 33 81 71 81 81 81 81 81 73 78 78 72 81 81 81 33 81 81 32 34 34 63 76 32 32 32 34 79 33 33 80 31 32 32 32 32 32 32 32 32 40 0 0 0 0 0 0 0 
0 0 0 0 0 0 0 0 0 0 39 47 81 81 81 81 81 44 39 42 34 34 33 70 34 34 31 64 62 80 75 65 31 33 31 32 32 81 81 34 81 81 31 33 80 79 81 79 81 81 79 31 33 31 31 31 31 31 80 31 31 31 31 31 80 31 31 31 81 32 32 32 32 75 65 34 67 32 34 79 33 33 33 33 33 33 33 33 33 33 32 32 44 0 0 0 0 0 0 0 
0 0 0 0 0 0 0 0 0 42 81 81 80 80 80 80 81 81 81 64 62 34 31 79 34 31 34 34 71 33 79 31 31 33 31 32 32 81 67 81 63 72 31 33 31 79 81 75 72 81 79 31 33 33 33 33 33 33 33 33 33 33 33 33 33 33 33 31 70 81 70 81 63 65 32 32 32 32 34 64 62 32 67 34 73 72 34 73 72 33 32 32 32 40 0 0 0 0 0 0 
0 0 0 0 0 0 0 0 0 39 62 80 80 67 81 80 73 72 81 81 64 72 33 64 78 78 78 72 34 33 71 31 33 33 80 34 34 67 81 63 76 81 80 33 31 75 77 65 81 63 76 31 31 80 31 61 61 61 60 60 61 61 61 60 61 61 61 31 75 77 76 81 71 81 73 72 32 34 34 32 71 32 32 34 32 32 32 32 34 33 32 32 32 44 0 0 0 0 0 0 
0 0 0 0 0 0 0 39 43 81 79 31 81 81 81 31 81 81 81 34 81 34 31 34 34 34 31 34 34 33 34 31 33 33 31 32 81 81 63 66 65 81 31 33 31 64 65 81 81 75 65 31 80 31 61 61 51 52 60 51 53 52 60 60 51 52 61 31 75 66 76 81 81 81 81 63 62 34 34 34 32 81 32 34 32 32 81 32 70 33 32 67 32 32 40 0 0 0 0 0 
0 0 0 0 0 0 42 81 81 81 71 80 81 81 81 80 81 81 81 81 67 34 33 31 31 34 34 31 31 33 34 33 33 31 31 81 81 63 66 65 81 70 31 33 31 81 34 81 63 65 34 70 31 61 60 61 55 57 53 48 48 57 53 53 58 56 61 31 64 74 74 72 81 81 81 75 76 34 34 32 32 32 32 34 81 81 67 32 71 33 32 32 32 32 40 0 0 0 0 0 
0 0 0 0 0 0 42 81 81 67 81 31 81 34 81 80 81 73 78 72 31 31 33 33 33 33 33 33 33 33 33 33 31 32 32 81 63 66 76 81 34 79 31 33 31 81 81 34 79 34 34 79 31 61 61 51 48 48 48 48 48 48 54 59 48 56 61 80 34 81 81 81 63 78 77 66 76 34 34 32 70 32 32 34 34 70 34 81 34 33 32 32 32 45 0 0 0 0 0 0 
0 0 0 0 0 0 0 46 81 81 81 80 81 81 67 80 31 31 31 33 33 33 33 33 33 33 33 33 33 31 31 31 80 32 81 34 75 66 76 81 63 65 80 31 80 81 70 81 71 34 34 71 31 61 68 55 48 48 48 48 48 49 60 55 48 56 61 31 34 81 63 77 65 81 75 66 66 72 32 32 71 32 67 34 34 71 34 73 72 33 32 32 45 0 0 0 0 0 0 0 
0 0 0 0 0 0 0 47 81 67 81 80 67 31 81 81 33 33 33 33 33 33 33 31 31 81 31 81 31 81 31 67 81 34 81 34 64 74 66 78 76 31 31 31 70 81 79 81 81 34 34 80 31 61 60 55 48 48 48 48 49 60 60 55 48 56 61 31 34 63 74 76 81 63 66 66 76 34 32 32 33 33 33 33 33 33 33 33 33 33 32 32 44 0 0 0 0 0 0 0 
0 0 0 0 0 0 42 81 81 81 81 80 31 81 81 81 81 33 31 31 80 31 31 81 73 78 72 81 81 34 34 34 80 80 80 80 80 80 79 81 71 31 33 31 79 81 75 72 81 70 34 31 80 61 61 55 48 48 48 49 60 60 51 48 48 56 61 31 34 71 81 64 77 66 66 66 66 62 32 34 33 33 70 34 32 32 32 32 67 32 32 32 32 44 0 0 0 0 0 0 
0 0 0 0 0 0 42 34 34 81 67 31 33 33 81 34 81 31 81 81 34 81 81 31 80 80 80 80 80 63 77 62 80 73 78 78 62 80 79 34 80 31 33 31 79 81 79 81 63 65 34 31 31 61 51 48 48 48 56 68 68 51 48 48 48 56 61 31 34 34 81 81 75 66 66 66 66 65 32 32 33 63 76 34 34 32 32 70 32 70 32 32 32 32 40 0 0 0 0 0 
0 0 0 0 0 0 42 81 81 70 31 81 33 31 31 81 81 81 73 62 81 81 70 80 80 81 81 70 80 75 66 76 80 34 34 81 71 80 71 81 31 33 31 31 75 77 76 81 79 34 34 80 31 60 55 48 48 48 49 60 68 55 48 48 54 49 61 80 69 34 67 81 75 66 66 66 76 32 32 70 33 75 66 78 78 77 77 74 77 76 32 32 32 32 40 0 0 0 0 0 
0 0 0 0 0 0 42 81 81 71 31 80 33 31 67 81 67 81 81 71 81 73 65 33 81 81 34 71 80 75 74 65 80 81 81 81 81 80 81 67 31 33 31 63 74 66 66 77 65 34 34 34 31 60 55 48 48 56 60 51 53 58 48 56 61 61 61 31 34 34 81 63 66 66 74 74 74 62 32 79 33 75 76 32 32 64 65 32 75 66 72 32 32 45 0 0 0 0 0 0 
0 0 0 0 0 0 42 81 34 81 81 80 33 31 80 31 31 67 81 34 81 34 81 80 73 72 81 81 80 71 81 81 80 81 81 67 81 33 67 31 31 33 80 71 81 75 66 76 34 70 34 34 80 60 50 59 48 57 53 58 48 48 48 56 61 60 61 31 34 34 81 75 66 76 32 32 32 64 77 65 33 64 65 32 32 32 32 32 75 76 32 32 45 0 0 0 0 0 0 0 
0 0 0 0 0 0 0 46 81 81 31 81 33 33 33 33 33 31 31 31 31 31 31 33 81 31 67 81 80 81 81 67 80 81 81 31 81 80 31 33 33 31 31 81 81 75 74 65 81 71 34 70 31 60 60 50 54 54 54 54 54 54 54 49 60 68 61 31 34 34 81 75 66 65 32 67 32 32 71 33 33 33 31 31 67 32 67 32 75 65 32 32 40 0 0 0 0 0 0 0 
0 0 0 0 0 0 0 42 34 67 34 31 31 31 80 31 33 33 33 33 33 80 33 80 81 81 81 81 80 81 81 81 80 81 81 81 81 33 33 31 31 31 70 81 81 79 81 81 70 81 63 65 31 31 61 61 61 61 61 61 61 61 61 61 61 61 31 80 34 73 77 66 76 32 32 31 31 32 33 33 33 33 80 80 32 81 31 32 79 32 32 32 44 0 0 0 0 0 0 0 
0 0 0 0 0 0 0 42 81 81 81 81 81 34 81 31 80 31 31 80 31 31 31 31 81 81 33 81 80 80 80 80 80 81 81 81 81 31 31 80 31 63 0 77 77 0 77 77 76 81 79 34 70 80 31 31 80 31 34 31 31 34 34 31 31 80 31 34 34 81 64 66 66 46 32 32 67 32 31 33 33 33 33 31 32 32 34 32 79 32 67 32 32 40 0 0 0 0 0 0 
0 0 0 0 0 0 0 42 81 81 73 78 72 81 81 81 81 67 81 81 81 81 67 31 31 81 81 81 34 81 81 81 31 31 73 78 78 78 77 78 78 0 0 0 0 0 0 0 42 81 71 34 79 34 34 34 63 62 34 34 34 34 34 69 34 34 34 34 70 81 81 75 0 42 32 31 34 32 67 31 33 33 31 67 32 31 32 32 71 32 32 32 32 40 0 0 0 0 0 0 
0 0 0 0 0 0 0 42 81 34 81 81 81 67 81 81 81 81 81 67 81 81 81 81 81 73 78 78 78 78 78 78 77 62 81 81 81 81 79 81 81 40 0 0 0 0 0 0 42 81 81 63 66 78 78 77 74 65 81 81 81 81 81 63 72 81 81 73 66 62 81 75 66 42 32 34 81 32 32 31 32 32 32 32 34 32 34 32 32 81 32 45 41 0 0 0 0 0 0 0 
0 0 0 0 0 0 0 43 81 81 73 62 81 81 34 81 67 81 81 81 81 34 81 34 81 81 81 81 34 34 81 81 64 65 81 63 77 78 65 81 45 0 0 0 0 0 0 0 42 34 81 64 65 81 81 71 81 81 34 81 81 67 34 71 81 81 81 81 64 74 78 66 0 42 32 32 34 31 32 34 32 32 67 32 32 32 32 31 32 34 45 0 0 0 0 0 0 0 0 0 
0 0 0 0 0 0 42 81 81 81 81 71 81 81 34 81 81 81 73 72 81 81 81 81 81 73 78 78 72 81 81 81 34 81 81 64 65 81 81 45 0 0 0 0 0 0 0 0 0 46 81 81 81 45 46 81 81 63 77 78 72 81 81 34 81 73 72 81 81 81 81 40 0 0 41 46 32 32 32 32 81 32 32 45 41 41 41 46 32 32 40 0 0 0 0 0 0 0 0 0 
0 0 0 0 0 0 0 41 41 46 81 81 67 81 34 34 81 81 81 81 73 72 81 81 81 81 81 81 81 81 70 81 81 81 34 34 81 81 81 44 0 0 0 0 0 0 0 0 0 0 41 41 41 0 42 81 73 74 65 81 81 67 81 73 72 81 81 81 45 41 41 0 0 0 0 0 41 41 41 41 41 41 41 0 0 0 0 0 46 32 40 0 0 0 0 0 0 0 0 0 
0 0 0 0 0 0 0 0 0 0 46 81 81 81 81 81 81 73 72 81 81 81 81 73 78 78 78 78 78 78 65 81 81 45 46 81 81 34 81 81 40 0 0 0 0 0 0 0 0 0 0 0 0 0 0 46 81 81 81 34 81 81 34 81 81 45 41 41 0 0 0 0 0 0 0 0 0 0 0 0 0 0 0 0 0 0 0 0 0 41 0 0 0 0 0 0 0 0 0 0 
0 0 0 0 0 0 0 0 0 0 0 41 41 41 46 81 81 81 81 81 34 81 81 81 81 34 81 81 81 81 81 81 45 0 0 41 41 41 41 41 0 0 0 0 0 0 0 0 0 0 0 0 0 0 0 42 81 45 41 41 41 41 41 41 41 0 0 0 0 0 0 0 0 0 0 0 0 0 0 0 0 0 0 0 0 0 0 0 0 0 0 0 0 0 0 0 0 0 0 0 
0 0 0 0 0 0 0 0 0 0 0 0 0 0 0 41 41 41 41 41 41 41 41 41 41 41 41 41 41 41 41 41 0 0 0 0 0 0 0 0 0 0 0 0 0 0 0 0 0 0 0 0 0 0 0 0 41 0 0 0 0 0 0 0 0 0 0 0 0 0 0 0 0 0 0 0 0 0 0 0 0 0 0 0 0 0 0 0 0 0 0 0 0 0 0 0 0 0 0 0 
0 0 0 0 0 0 0 0 0 0 0 0 0 0 0 0 0 0 0 0 0 0 0 0 0 0 0 0 0 0 0 0 0 0 0 0 0 0 0 0 0 0 0 0 0 0 0 0 0 0 0 0 0 0 0 0 0 0 0 0 0 0 0 0 0 0 0 0 0 0 0 0 0 0 0 0 0 0 0 0 0 0 0 0 0 0 0 0 0 0 0 0 0 0 0 0 0 0 0 0 
0 0 0 0 0 0 0 0 0 0 0 0 0 0 0 0 0 0 0 0 0 0 0 0 0 0 0 0 0 0 0 0 0 0 0 0 0 0 0 0 0 0 0 0 0 0 0 0 0 0 0 0 0 0 0 0 0 0 0 0 0 0 0 0 0 0 0 0 0 0 0 0 0 0 0 0 0 0 0 0 0 0 0 0 0 0 0 0 0 0 0 0 0 0 0 0 0 0 0 0 
